{
  "height": 24,
  "width": 80,
  "worldBorder": true,
  "spawnpoint": {
    "x": 32,
    "y": 150
  },
  "tiles": [
    ". . . . . . . . . . . . . . . . . . . . . . . . . . . . . . . . . . . . . . . . ",
    ". . . . . . . . . . . . . . . . . . . . . . . . . . . . . . . . . . . . . . . . ",
    ". . . . . . . . . . . . . . . . . . . . . . . . . . . . . . . . . . . . . . . . ",
    ". . . . . . . . . . . . . . . . . . . . . . . . . . . . . . . . . . . . . . . . ",
    ". . . . . . . . . . . . . . . . . . . . . . . . . . . . . . . . . . . . . . . . ",
    ". . . . . . . . . . . . . . . . . . . . . . . . . . . . . . . . . . . . . . . . ",
    ". . . . . . . . . . . . . . . . . . . . . . . . . . . . . . . . . . . . . . . . ",
    ". . . . . . . . . . . . . . . . . . . . . . . . . . . . . . . . . . . . . . . . ",
    ". . . . . . . . . . . . . . . . . . . . . . . . . . . . . . . . . . . . . . . . ",
    ". . . . . . . . . . . . . . . . . . . . . . . . . . . . . . . . . . . . . . . . ",
    ". . . . . . . . . . . . . . . . . . . . . . . . . . . . . . . . . . . . . . . . ",
    ". . . . . . . . . . . . . . . . . . . . . . . . . . . . . . . . . . . . . . . . ",
    ". . . . . . . . . . . . . . . . . . . . . . . . . . . . . . . . . . . . . . . . ",
    ". . . . . . . . . . . . . . . . . . . . . . . . . . . . . . . . . . . . . . . . ",
    ". . . . . . . . . . . . . . . . . . . . . . . . . . . . . . . . . . . . . . . . ",
    ". . . . . . . . .#.#.#.#.#. . . . . . . . . . . . . . . . . . . . . . . . . . . ",
    ". . . . . . .#.#.#.#.#.#.#.#.#.#.#. . . . . . . . . . . . . . . . . . . . . . . ",
    ". . . . . .#.#.#.#.#.#.#.#.#.#.#.#.#. . . . . . . . . . . . . . . . . . . . . . ",
    ". . . . . .#.#.#.#.#.#.#.#.#.#.#.#. . . . . . . . . . . . . . . . . . . . . . . ",
    ". . . . . . . .#.#.#.#.#.#.#.#. . . . . . . . . . . . . . . . . . . . . . . . . ",
    ". . . . . . . . . . . . . . . . . . . . .#.#.#.#.#. . . . . .#.#.#.#.#. . . . . ",
    ". . . . . . . . . . . . . . . . . . . . . . . . . . . . . . . . . . . . . . . . ",
    ". . . . . . . . . . . . . . . . . . . . . . . . . . . . . . . . . . . . . . . . ",
    ".#.#.#.#.#.#.#.#.#.#.#.#.#.#.#.#.#.#.#.#.#.#.#.#.#.#.#.#.#.#.#.#.#.#.#.#.#.#.#.#"
  ]
}
